1111111111111
1P0000000E001
1011000110001
1010C00010001
1000010000001
1000111000001
1000010000001
1010000010001
1C11000110001
1000000000001
1111111111111