1111111111111111111111111111111111
100000000000000C00000C000000000001
1010010100110000101001000000010101
1010010100110000101001000000010101
1010010111000010001001000000010101
1P1000000C01C00000E000000000000C01
1111111111111111111111111111111111